NO ./textures/mossy.xpm
SO ./textures/redbrick.xpm
WE ./textures/redbrick.xpm
EA ./textures/mossy.xpm

F 31,100,32
C 140,189,214

        1111111111111111111111111
        1000000000110000000000001
        1011000001110000000000001
        1001000000000000000000001
111111111011000001110000000000001
1E00000000110000011DGC11111111111
111DGC11111111011100000010001
11110111111111011101010010001
1100000011010101A10000001000111A11111111
1000000000000000G00000001000000G00000001
1000000000000000B10101001000111B11110001
110000011101010111110111A000111    111101
11110111 1110101 1010000G0001          1
11111111 1111111 1111111B111
